1,1,1,1,1,1,1,1,1,1,1,1,1,1,1,1,1,1,1,1,1,1,1,1,1,1,1,1,1,1,1,1,1,1,1,1,1,1,1,1
1,0,0,2,0,0,0,0,0,1,1,0,0,2,0,0,0,0,1,1,0,0,0,2,0,0,0,0,1,1,0,0,0,0,3,0,0,0,2,1
1,0,0,0,0,0,2,0,2,1,1,0,2,0,0,0,2,0,1,1,0,2,0,0,0,2,0,0,1,1,0,0,0,0,0,0,0,0,0,1
1,0,0,0,3,0,0,0,0,1,1,0,2,0,2,0,0,0,1,1,0,0,0,0,0,0,0,0,1,1,0,0,3,0,0,0,0,2,0,1
1,2,0,0,0,0,0,3,0,1,1,0,0,0,0,0,0,2,1,1,0,0,0,2,0,0,0,0,1,1,0,0,0,0,0,0,0,0,0,1
1,1,1,1,1,1,0,0,1,1,1,1,1,1,0,0,1,1,1,1,1,1,1,1,0,0,1,1,1,1,1,1,0,0,1,1,1,1,1,1
1,ts|3|3,ts|3|3,ts|3|3,ts|3|3,ts|3|3,ts|3|3,ts|3|3,ts|3|3,ts|3|3,ts|3|3,ts|3|3,ts|3|3,ts|3|3,ts|3|3,ts|3|3,ts|3|3,ts|3|3,ts|3|3,ts|3|3,ts|3|3,ts|3|3,ts|3|3,ts|3|3,ts|3|3,ts|3|3,ts|3|3,ts|3|3,ts|3|3,ts|3|3,ts|3|3,ts|3|3,ts|3|3,ts|3|3,ts|3|3,ts|3|3,ts|3|3,ts|3|3,ts|3|3,1
1,ts|3|3,ts|3|3,ts|3|3,ts|3|3,ts|3|3,ts|3|3,ts|3|3,ts|3|3,ts|3|3,ts|3|3,ts|3|3,ts|3|3,ts|3|3,ts|3|3,ts|3|3,ts|3|3,ts|3|3,ts|3|3,ts|3|3,ts|3|3,ts|3|3,ts|3|3,ts|3|3,ts|3|3,ts|3|3,ts|3|3,ts|3|3,ts|3|3,ts|3|3,ts|3|3,ts|3|3,ts|3|3,ts|3|3,ts|3|3,ts|3|3,ts|3|3,ts|3|3,ts|3|3,1
1,nt|900|0|1|1|1#np|7|14|30,0,0,0,0,0,0,0,0,0,0,0,0,0,0,0,0,0,0,0,0,0,0,0,0,0,0,0,0,2,0,0,0,0,0,0,0,nt|900|180|1|1|1#np|7|14|30,1
1,nt|900|0|1|1|1#np|7|14|30,0,0,0,0,0,0,0,0,2,0,0,0,0,0,0,0,2,0,0,0,0,0,0,0,0,0,0,0,0,0,0,2,0,0,0,0,nt|900|180|1|1|1#np|7|14|30,1
1,1,1,1,1,1,1,1,1,1,1,1,1,1,1,1,1,1,1,1,1,1,1,1,1,1,1,1,1,1,1,1,1,1,1,1,1,1,1,1