0,0,0,0,0,0,0,0,0,0,0,0,0,9,9,9,9,9,9,9,0,0,0,0,0,9,9,9,9,9,9,9,0,0,0,0,0,9,9,9,9,9,9,9,0,0,0,0,0,9,9,9,9,9,9,9,0,0,0,0,
0,0,5,0,0,0,0,0,9,9,9,9,9,9,9,0,0,0,0,0,9,9,9,9,9,9,9,0,0,0,0,0,9,9,9,9,9,9,9,0,0,0,0,0,9,9,9,9,9,9,9,0,0,0,0,0,9,9,9,9,9,9,9,0,0,0,0,
0,0,0,0,0,0,0,9,9,9,9,9,9,9,0,0,0,0,0,9,9,9,9,9,9,9,0,0,0,0,0,9,9,9,9,9,9,9,0,0,0,0,0,9,9,9,9,9,9,9,0,0,0,0,0,9,9,9,9,9,9,9,0,0,0,0,
0,0,0,0,0,0,0,0,9,9,9,9,9,9,9,0,0,0,0,0,9,9,9,9,9,9,9,0,0,0,0,0,9,9,9,9,9,9,9,0,0,0,0,0,9,9,9,9,9,9,9,0,0,0,0,0,9,9,9,9,9,9,9,0,0,0,0,
0,0,0,0,0,0,0,0,9,9,9,9,9,9,9,0,0,0,0,0,9,9,9,9,9,9,9,0,0,0,0,0,9,9,9,9,9,9,9,0,0,0,0,0,9,9,9,9,9,9,9,0,0,0,0,0,9,9,9,9,9,9,9,0,0,0,0,
9,9,9,9,9,9,9,9,0,0,0,0,0,9,9,9,9,9,9,9,0,0,0,0,0,9,9,9,9,9,9,9,0,0,0,0,0,9,9,9,9,9,9,9,0,0,0,0,0,9,9,9,9,9,9,9,0,0,0,0,
4,9,9,9,9,9,9,9,0,0,0,0,0,9,9,9,9,9,9,9,0,0,0,0,0,9,9,9,9,9,9,9,0,0,0,0,0,9,9,9,9,9,9,9,0,0,0,0,0,9,9,9,9,9,9,9,0,0,0,0,
4,9,9,9,9,9,9,9,0,0,0,0,0,9,9,9,9,9,9,9,0,0,0,0,0,9,9,9,9,9,9,9,0,0,0,0,0,9,9,9,9,9,9,9,0,0,0,0,0,9,9,9,9,9,9,9,0,0,0,0,
4,9,9,9,9,9,9,9,0,0,0,0,0,9,9,9,9,9,9,9,0,0,0,0,0,9,9,9,9,9,9,9,0,0,0,0,0,9,9,9,9,9,9,9,0,0,0,0,0,9,9,9,9,9,9,9,0,0,0,0,
4,9,9,9,9,9,9,9,0,0,0,0,9,9,9,9,9,9,9,0,0,0,0,0,9,9,9,9,9,9,9,0,0,0,0,0,9,9,9,9,9,9,9,0,0,0,0,0,9,9,9,9,9,9,9,0,0,0,0,
4,9,9,9,9,9,9,9,0,0,0,0,0,9,9,9,9,9,9,9,0,0,0,0,0,9,9,9,9,9,9,9,0,0,0,0,0,9,9,9,9,9,9,9,0,0,0,0,0,9,9,9,9,9,9,9,0,0,0,0,
4,9,9,9,9,9,9,9,0,0,0,0,0,9,9,9,9,9,9,9,0,0,0,0,0,9,9,9,9,9,9,9,0,0,0,0,0,9,9,9,9,9,9,9,0,0,0,0,0,9,9,9,9,9,9,9,0,0,0,0,
4,9,9,9,9,9,9,9,0,0,0,0,0,9,9,9,9,9,9,9,0,0,0,0,0,9,9,9,9,9,9,9,0,0,0,0,0,9,9,9,9,9,9,9,0,0,0,0,0,9,9,9,9,9,9,9,0,0,0,0,
4,9,9,9,9,9,9,9,0,0,0,0,0,9,9,9,9,9,9,9,0,0,0,0,0,9,9,9,9,9,9,9,0,0,0,0,0,9,9,9,9,9,9,9,0,0,0,0,0,9,9,9,9,9,9,9,0,0,0,0,
4,9,9,9,9,9,9,9,0,0,0,0,0,9,9,9,9,9,9,9,0,0,0,0,0,9,9,9,9,9,9,9,0,0,0,0,0,9,9,9,9,9,9,9,0,0,0,0,0,9,9,9,9,9,9,9,0,0,0,0,
4,9,9,9,9,9,9,9,0,0,0,0,0,9,9,9,9,9,9,9,0,0,0,0,0,9,9,9,9,9,9,9,0,0,0,0,0,9,9,9,9,9,9,9,0,0,0,0,0,9,9,9,9,9,9,9,0,0,0,0,
4,9,9,9,9,9,9,9,0,0,0,0,0,9,9,9,9,9,9,9,0,0,0,0,0,9,9,9,9,9,9,9,0,0,0,0,0,9,9,9,9,9,9,9,0,0,0,0,0,9,9,9,9,9,9,9,0,0,0,0,
4,9,9,9,9,9,9,9,0,0,5,0,0,9,9,9,9,9,9,9,0,0,0,0,0,9,9,9,9,9,9,9,0,0,0,0,0,9,9,9,9,9,9,9,0,0,0,0,0,9,9,9,9,9,9,9,0,0,0,0,
4,9,9,9,9,9,9,9,0,0,0,0,0,9,9,9,9,9,9,9,0,0,0,0,0,9,9,9,9,9,9,9,0,0,0,0,0,9,9,9,9,9,9,9,0,0,0,0,0,9,9,9,9,9,9,9,0,0,0,0,
4,9,9,9,9,9,9,9,0,0,0,0,0,9,9,9,9,9,9,9,0,0,0,0,0,9,9,9,9,9,9,9,0,0,0,0,0,9,9,9,9,9,9,9,0,0,0,0,0,9,9,9,9,9,9,9,0,0,0,0,
4,9,9,9,9,9,9,9,0,0,0,0,0,9,9,9,9,9,9,9,0,0,0,0,0,9,9,9,9,9,9,9,0,0,0,0,0,9,9,9,9,9,9,9,0,0,0,0,0,9,9,9,9,9,9,9,0,0,0,0,
4,9,9,9,9,9,9,9,0,0,0,0,0,9,9,9,9,9,9,9,0,0,0,0,0,9,9,9,9,9,9,9,0,0,0,0,0,9,9,9,9,9,9,9,0,0,0,0,0,9,9,9,9,9,9,9,0,0,0,0,
4,9,9,9,9,9,9,9,0,0,0,0,0,9,9,9,9,9,9,9,0,0,0,0,0,9,9,9,9,9,9,9,0,0,0,0,0,9,9,9,9,9,9,9,0,0,0,0,0,9,9,9,9,9,9,9,0,0,0,0,
4,9,9,9,9,9,9,9,0,0,0,0,0,9,9,9,9,9,9,9,0,0,0,0,0,9,9,9,9,9,9,9,0,0,0,0,0,9,9,9,9,9,9,9,0,0,0,0,0,9,9,9,9,9,9,9,0,0,0,0,
4,9,9,9,9,9,9,9,0,0,0,0,0,9,9,9,9,9,9,9,0,0,0,0,0,9,9,9,9,9,9,9,0,0,0,0,0,9,9,9,9,9,9,9,0,0,0,0,0,9,9,9,9,9,9,9,0,0,0,0,
4,9,9,9,9,9,9,9,0,0,0,0,0,9,9,9,9,9,9,9,0,0,0,0,0,9,9,9,9,9,9,9,0,0,0,0,0,9,9,9,9,9,9,9,0,0,0,0,0,9,9,9,9,9,9,9,0,0,0,0,
